33333333333333333333333333333333
32222222222222222222222222222223
32222222222222222222222222222223
35222222222222222222222222222223
33333333333333333333333333322223
32222222222222222222222222222223
32222222222222222222222222222223
32222222222222222222222222222223
32223334433443334444433343333333
32223333333333333333333333333333
32222222222222222222222222222223
32222222222222222222222222222223
32222222222222222222222222222223
32222222222222222222222222222223
32222222222222222222222233332223
33334443333443334443334432232223
32234443223443234443234432232223
32233333223333233333233332232223
32222222222222222222222222222223
32222222222222222222222222222223
32222222222222222222222222222223
32222222222222222222222222222223
32222222222222222222222222233333
32223334444444444443333333333333
32222234444444444443222222222223
32222233333333333333222222222223
32222222222222222222222222222263
32222222222222222222222222222233
33332222222222222222222222223333
34433322322232222322232233333443
34444334444444444444444433344443
33333333333333333333333333333333